1111111111
10C100C101
100C000001
1CCC000C01
1000000PE1
1000000001
1000010001
10000000C1
10C0000C01
1111111111
