1111111111
1000101001
1000000001
1000000001
1001000001
1010000011
101C000001
10000000C1
1010000011
10000001P1
1010001001
1000001010
1000E00001
1000000001
100E000001
1001000201
1C00000001
1000000011
1001000001
1111111111
