1111111111
100E00CCC1
10CC001001
100C000001
1C01000101
1C0000C001
10C0000C01
100000C001
10CCP00001
1111111111
