1111111111
1C0C000001
10100000C1
1010000001
1C000E0101
10C001C0C1
100000CC11
1P11C00C01
1010000011
1111111111
